1111111111
1P000000E1
1111011111
1C000001C1
1011111101
1000000001
1111111111
