1111111111
1P00000001
1111E11111
1C000000C1
1011111101
100000R001
1111111111
