111111111111111111111
1P00000110000000000E1
101110011101111111101
100010000001000000001
101011111101011111101
100000000001000000001
111011101111011101101
1C0001000000001000001
101111111011111111101
1C00000000100000000C1
101111101111101111101
111111111111111111111
