1111111111111
1P0000000R001
10111101111R1
1C000C00000E1
10101111111R1
1C00000000001
1111111111111
