1111111
1P000C1
1111011
1C0R001
1E11111
1111111
