111111
1P0001
111101
100001
1C0E11
111111
