111111111111111111111
1P0000011000000C00E11
101110011101111011101
1C0010000R01000000C01
101011110101011111101
1C0000R00000000000001
111011100000011101101
1C00010000000010R0001
101111111011111111101
1C00R00000000000000C1
101111101111101111101
111111111111111111111
