1111111111
1P000000E1
1011111101
1C000000C1
1010111101
1C01000001
1010111101
1C000000C1
1011111101
1111111111


