1111111
1P000C1
1001001
1E00001
1111111
