111111111111111
1P0000000010001
101111111101010
1C0000000000C01
111101111101111
1C0001000010001
111101111111101
100000000000001
101111101111101
1C0000010000C01
111110111101111
1C0001000010001
101101111111101
1E0000000000001
111111111111111

