1111111111111
1P00000000001
1011110111101
1C000C00000E1
1010111111101
1C00000000001
1111111111111
