1111111111111
1C01000100001
1010111010001
1001C100C0001
1000000010111
1000111011E01
1C0000000C1P1
1000000000001
1111111111111
