1111111111111
1C00000100001
1000011010001
1000C100C0001
1000000010001
1000111010E01
1C0000000C0P1
1000000000001
1111111111111
