1111111111111
1P00000100001
1000011010001
1000C100C0001
1000000010001
1000111010001
1C0000000C0E1
1000000000001
1111111111111
