1111111111111
1C01000100001
1010111010001
1001C100C0001
1000000010001
1000111010E01
1C00000R0C0P1
1000000000001
1111111111111
