1111111
1P000C1
1111011
1C00001
1E11111
1111111
